B917915793
AE856C552A
AFC53FFFEA
AFD5057F92
AFFFAFFFAE
C3BFAFD503
BC2FAFFFEA
83AD45393A
AAA953EAAA
EC46D456C6

0 0
9 9
SSSSSESESSSENEESEENNESSE
